+--+--+--+--+--+--+--+--+--+--+--+--+--+--+--+
   |           |              |              |
+  +--+--+--+  +  +--+--+--+  +  +--+--+--+  +
|        |  |        |        |  |           |
+--+--+  +  +--+--+  +  +--+--+  +--+--+  +  +
|        |     |     |     |  |  |        |  |
+  +--+--+--+  +  +--+--+  +  +  +  +--+--+  +
|  |           |  |     |  |     |  |     |  |
+  +  +--+--+  +  +  +--+  +  +--+  +--+  +  +
|  |        |  |  |           |     |     |  |
+  +--+--+  +--+  +--+--+  +--+  +--+  +--+--+
|     |     |     |        |     |     |     |
+--+  +  +--+  +--+--+--+--+  +--+  +--+--+  +
|  |                 |     |        |     |  |
+  +--+--+--+--+--+  +--+  +--+--+--+  +  +  +
|  |              |        |        |  |  |  |
+  +  +  +--+  +  +  +--+--+--+--+  +  +  +  +
|  |  |     |  |  |  |     |        |  |  |  |
+  +--+--+  +  +--+  +  +  +  +--+  +  +  +  +
|           |        |  |  |  |     |  |  |  |
+--+--+--+  +--+--+--+  +  +  +  +--+--+  +  +
|        |           |  |     |        |     |
+  +  +--+--+--+  +  +  +--+--+--+--+  +--+  +
|  |              |  |  |           |  |     |
+  +--+--+--+--+--+--+  +  +--+--+  +  +  +--+
|  |           |     |  |     |  |     |  |  |
+  +  +--+--+  +  +  +  +--+  +  +--+--+  +  +
|  |  |        |  |  |  |     |  |     |     |
+  +  +  +--+--+  +  +  +  +--+  +  +  +--+  +
|     |           |     |           |         
+--+--+--+--+--+--+--+--+--+--+--+--+--+--+--+